11111111111111111111
10000000000000000001
10110111110000000001
10110100010000000001
10110111110000000001
10000000000000000001
10111011010101111101
10111011010101111101
10000000000000000001
11111111111111111111