1111111111
1000000001
1011011111
1011010001
1011011111
1000000001
1011101101
1111111111